##############################
#22           # C  #         #
###  #        #    #         #
#    #   #    #    #    #    #
#    ####L                   1
#    ####               0    1
#    #   #    #    #    #    #
#    #                       #
#                            #
##############################