     &&&&&&&&&&&&&&&&&&&&&&&&&&&&&&&&&&&&&&&&&     
    &  /---                                   &    
   &   |]]]                                    &   
  &    \---                                     &  
 &                                               & 
&                                                 &
&                                                 &
&                                                 &
&                   &&&   &&&                     &
&                  &         &                    &
&                                                 &
&                  &         &                    &
&                   &&&   &&&                     &
&                                                 &
&                                                 &
&                                                 &
&                                                 &
&                                                 &
&                                                 &
&&&&&&&&&&&&&&&&&&&&&&&&&&&&&&&&&&&&&&&&&&&&&&&&&&&