#################################
#110      t    t       t      t #
###    #    #    #    #    #    #
#            t     t       t    #
#      #    #    #   t#    #  t #
#      #         ################
#      #                        #
#      #    #    #    #       ###
#      #                      22#
#################################